########################################################
#....#........................#........................#
#....#........................#........................#
#....#........................#........................#
#....#........................#........................#
#....#....#####################........................#
#....#....#...................#........................#
#....#....#...................#........................#
#....#....#...................#........................#
#....######...................###################......#
#............~~~~~~~~~~~~~.......................#......#
#............~~~~~~~~~~~~~.......................#......#
#................................................#......#
#................................................#......#
#......######################....................#......#
#......#....................#....................#......#
#......#....................#....................#......#
#......#....................#....................#......#
#......#....................#....................#......#
#......#....................#....................#......#
#......#....................#....................#......#
#......#....................#....................#......#
#......#....................#....................#......#
#......#....................#....................#......#
#......#....................#....................#......#
#......#....................#....................#......#
#......#....................#....................#......#
#......#....................#....................#......#
#......#....................#....................#......#
#......#....................#....................#......#
########################################################