#######################################
#........#...............#............#
#..######..#########..#####..######...#
#..#...............#..#......#....#...#
#..#..#######..####..#####..#....#...##
#..#..#.....#..#.............#....#...#
#..#..#.....#..#..#######..#####..##### 
#..#..#.....#..#..#.....#..#....#.....#
#..#..#######..#..#.....#..#....####..#
#..........#....#..#####..#........#..#
######..#..#######........#####....#..#
#....#..#...........####..#....#....#..#
#....#..#..##########.....#....#######.#
#....#..#..#........#####...#..........#
#######..#######..#........#########..#
#.................#..####...........#..#
#..#####..#####..####..#########..#####
#..#.....#.....#..........#......#.....#
#..#.....#.....#######..#.#......#.....#
#..#.....#.....#.....#..#.#......#.....#
#..#######..#..#.....####.#......#####.#
#............#..#########.#..........#.#
#######################################